user
Name a place in World of Warcraft lore for every character of the alphabet. Original vanilla WoW only, no expansions. Starting with "A for Azeroth".

assistant
Sure! Hereâ€™s a list of places in World of Warcraft lore, one for each letter of the alphabet, based on the original vanilla WoW:

A - Azeroth  
B - Blackrock Mountain  
C - Darnassus  
D - Darkshore  
E - Elwynn Forest  
F - Felwood  
G - Gnomeregan  
H - Hillsbrad Foothills  
I - Ironforge  
J - Jade Forest (Note: This is from Mists of Pandaria, but for vanilla, we can use "J - The Barrens" as a close substitute)  
K - Kalimdor  
L - Loch Modan  
M - Mulgore  
N - Northern Stranglethorn  
O - Orgrimmar  
P - Plaguelands  
Q - Quel'Thalas  
R - Redridge Mountains  
S - Stormwind  
T - Tanaris  
U - Un'Goro Crater  
V - Vashj'ir (Note: This is from Cataclysm, but for vanilla, we can use "V - The Hinterlands" as a close substitute)  
W - Westfall  
X - Xavian (Note: This is not from vanilla WoW, but for vanilla, we can use "X - The Exodar" as a close substitute, though it's from The Burning Crusade)  
Y - Ysera's Rest (Note: This is not from vanilla WoW, but for vanilla, we can use "Y - Ymiron's Grave" in Eastern Plaguelands as a close substitute)  
Z - Zul'Gurub (Note: This is a raid from vanilla WoW, but for a zone, we can use "Z - Zul'Farrak")

I hope this helps! [end of text]


