system
user
Name a place in World of Warcraft lore for every character of the alphabet. Original vanilla WoW only, no expansions. Starting with "A for Azeroth".
assistant
Here are places in World of Warcraft lore, one for each letter of the alphabet, using only original vanilla WoW content:

A - Azeroth
B - Booty Bay
C - Crossroads
D - Deadmines
E - Eastern Kingdoms
F - Felwood
G - Gadgetzan
H - Hillsbrad Foothills
I - Ironforge
J - Jintha'Alor
K - Karazhan
L - Loch Modan
M - Menethil Harbor
N - Nagrand (note: while Nagrand was not fully implemented in vanilla WoW, it was mentioned in lore and had a small presence in the game)
O - Orgrimmar
P - Plaguewood
Q - Quel'Thalas
R - Razor Hill
S - Stranglethorn Vale
T - Tanaris
U - Uldaman
V - Valley of Trials
W - Wetlands
X - Xavian (a small, obscure location in the Deadmines)
Y - Yojamba Isle
Z - Zul'Gurub

Note that some of these locations may have been more prominent or well-known than others, but they all existed in the original vanilla WoW game. [end of text]


