<|im_start|>user
Name a place in World of Warcraft lore for every character of the alphabet. Original vanilla WoW only, no expansions. Starting with "A for Azeroth".
<|im_end|>
<|im_start|>assistant
Sure, here are some places in World of Warcraft lore for every character of the alphabet, starting with "A for Azeroth":

A: Azeroth
B: Blackrock Mountain
C: Cenarion Hold
D: Dun Morogh
E: Elwynn Forest
F: Feralas
G: Gnomeregan
H: Hillsbrad Foothills
I: Ironforge
J: Jade Forest
K: Karazhan
L: Loch Modan
M: Menethil Harbor
N: Netherstorm
O: Orgrimmar
P: Pandaria
Q: Queen Azshara's Palace
R: Redridge Mountains
S: Silvermoon City
T: Tirisfal Glades
U: Uldum
V: Val'sharah
W: Winterspring
X: Xoroth (not in vanilla WoW, but added in Cataclysm)
Y: Ysera's Dream
Z: Zul'Gurub

I hope this helps! Let me know if you have any other questions. [end of text]


